11111111111111111111111111111111111111111
12111011111110011111100000001111111111111
10011011001111000000001111100111111111111
11000011101111110111111111110000111111111
11111011101111110000000000111011111111111
11111000000111111111111010111000111111111
11111101111111111111110010111110111111111
10001101111111101111010110100010111111111
10101100000000000000010110110110011111111
10101001111011101111110110110111000000011
10100011011011101100000110110111100111011
10110111011011101101111110010000101111011
10110000011011011101111111110001101111011
10100111111011011000000000000111101111001
10101111110011011011111111111111101000101
11000000001111011000000000000011101010101
11000111100001000011011101111011101010101
11100111100111111111011101100000100010101
11111111110011111000011101101111111110101
11110000111001111011011101100000000110101
11110110011101111011010101101101110110101
11110111011101110011000101100001000100101
11110100011101000111111101101111111101101
11000111011101011100000001100000000001101
10011111011100010001110111111111111111101
10111110011111110111110000000001111111001
10100010010000000011110111111110100000011
10101010110110111100001111111101111111111
10001010110110111001110000111100011000111
11110010100110000101110110111111001010111
11100110101111110101110110000011100010011
11001000001110000101110111111010111111011
11011101111111000001110110001010000000011
10010000000000000001110110101011111111111
10111111111111111100000110101000000000001
10111111111111111111111110111111111111101
10000000000000000001000010000000000011101
11011011111111111101011011111111111000001
11011011111111111100011000000000001111111
10011000000000000011111111111111100000031
11111111111111111111111111111111111111111
